PPPPPPPPPPPPPPPPPPPPPPPPPPPPPP;
P***PPPPPPPPPPPPPPPPPPPPPP***P;
P*P************************P*P;
P*PPPPP*PPPPPPPPPPPPPP*PPPPP*P;
P****************************P;
P*PPPPPPPPPPP=PPPPPPPPPPPPPP*P;
P******PP    F      PP*******P;
P*PPPP*PP           PP*PPPPP*P;
P*PPPP*PP           PP*PPPPP*P;
P*PPPP*PPPPPPPPPPPPPPP*PPPPP*P;
P*************I**************P;
P*PPPP*PPPPPPPPPPPPPPP*PPPPP*P;
P****************************P;
PPPPPPPPPPPPPPPPPPPPPPPPPPPPPP