PPPPPPPPPPPP;
PF=*******PP;
PPPPPPP*PPPP;
PP*********P;
PP*PPPPPPPPP;
PP*PPPIPPPPP;
PP*PPP*PPPPP;
PP*PPP*PPPPP;
PP********PP;
PP*PPPPPPPPP;
PPPPPPPPPPPP