PPPPPPPPPPPPPPPPPPPPPPPPPPPPPP;
P***PPPPPPPPPPPPPPPPPPPPPP***P;
P*P************************P*P;
P*PPPPPPPPPP*****PPPPPPPPPPP*P;
P****************************P;
P*PPPPPPPPPPP=PPPPPPPPPPPPPP*P;
P******PP           PP*******P;
P*PPPP*PP     F     PP*PPPPP*P;
P*PPPP*PP           PP*PPPPP*P;
P*PPPP*PPPPPPPPPPPPPPP*PPPPP*P;
P*************I**************P;
P*PPPP*PPPPPPPPPPPPPPP*PPPPP*P;
P****************************P;
PPPPPPPPPPPPPPPPPPPPPPPPPPPPPP